==A...........
==............
==............
==............
==............
==............
==............
==............
==............
==............
==............
==............
==............
==............
==............
==............
==k...........
==............
==............
==g...........
==g...........
==g...........
==............
==............
==............
==............
==............
==............
==............
==............
==g...........
==g...........
==g...........
==............
==............
==............
==............
==............
==............
==............
==............
==............
==k...........
==k...........
==ppp.........
==ppp.........
==............
==............
==............
..............
..............
==ppp.........
==ppp.........
==............
==............
==............
==............
==............
==............
==............
==............
==k...........
==............
==............
==............
==g...........
==g...........
==g...........
==............
==............
==............
==............
==............
==............
==............
==............
==g...........
==g...........
==g...........
==............
==............
==............
==............
==............
==............
==............
==............
==k...........
==............
==----........
==...-...b....
==...-...b....
.....-...b....
.....-........
..............
..............
==............
==............
==............
==............
==............
==............
==............
==g...........
==g...........
==g...........
==............
==............
==............
==............
==............
==.8..........
==............
==............
..............
..............
==---.........
==............
==............
==............
==............
==g...........
==g...........
==g...........
==............
==............
==............
==k...........
==............
==............
==............
==............
==............
==............
==............
==g...........
==g...........
==g...........
==............
==............
==............
==............
==............
==............
==............
==k...........
==k...........
==----........
==............
==...b........
==...b........
==............
..............
..............
..............
==............
==...-pp......
==...-pp......
==............
==.8..........
==............
==............
==............
==pp..........
==pp..........
==............
==............
==............
==............
==............
==.8..........
==............
==............
==............
==............
==............
==............
==............
==k...........
==............
==............
==............
==-...k.......
==--..........
==---.........
==----........
==-----.......
==............
==............
==..------....
==..------....
==............
==............
==............
==............
==............
==............
==............
==............
==F...........
==............
==............
==............
==A...........
