==A...........
==............
==............
==............
==............
==............
==............
==............
==............
==............
==............
==............
==............
==............
==............
==............
==............
==............
==............
==............
==............
==............
==............
==g...........
==g...........
==g...........
==............
==............
==............
==............
==g...........
==g...........
==g...........
==............
==............
==pppp........
==pppp........
==............
==............
==............
==............
==............
==............
==............
==k...........
==k...........
..............
==............
..............
==............
==............
..............
==............
==............
..............
==............
==............
..............
==............
==............
==............
==k...........
==............
==............
==....0.......
==............
==............
==............
==............
==g...........
==g...........
==g...........
==............
==............
==............
==............
==pppp........
==pppp........
==............
==............
==............
==............
==ppp.........
==ppp.........
==............
==............
==............
==............
==............
==....0.......
==............
==............
==............
==............
==pppp........
==pppp........
==............
==............
==....0.......
==............
==............
==............
==............
==............
==pppp........
==pppp........
==............
==............
==g...........
==g.......0...
==g.......0...
==............
==............
==............
==............
==pp..........
==pp..........
==............
==............
==k...........
==............
==............
==............
==............
==k...........
==k...........
==k...........
==............
==............
==............
==k...........
==k...........
==k...........
==............
==............
==............
==............
==............
==............
==............
==ppp.........
==ppp.........
==............
==............
==............
==............
==............
==............
==g...........
==g...........
==g...........
==............
==............
==----........
==.......b....
==.......b....
==.......b....
==.......b....
==.......b....
==.......b....
==.......b....
==k......b....
==............
==----........
==............
==............
==............
==............
==............
..............
==............
..............
==k...........
==............
..............
==............
..............
==k...........
==............
..............
==............
==............
==............
==............
==....b.......
==....b.......
==....b.......
==....b.......
==....b.......
==....b.......
==....b.......
==....b.......
==............
==............
==............
==............
==............
..............
==............
..............
==............
..............
==............
==............
==............
==............
==............
==............
==k...........
==k...........
==--..........
==............
==............
==............
==............
==............
==............
==............
==............
==............
==............
..............
..............
......0.......
......0.......
..............
..............
==............
==............
==............
==............
==............
==g...........
==g...........
==g...........
==............
==............
..............
==ppp.........
==ppp.........
..............
..............
==pppp........
==pppp........
..............
..............
==ppppp.......
==ppppp.......
==............
==............
==............
==............
==............
==............
==............
==............
==............
==g...........
==g...........
==g...........
==............
==............
==............
==............
==g...........
==g...........
==g...........
==............
==............
==............
==............
==............
==............
==g...........
==g...........
==-...........
==--..........
==---.........
==----........
==-----.......
==------......
==............
==............
==....0.......
==....0.......
==............
==............
==............
==............
==............
..............
......0.......
..............
==............
==............
..............
......0.......
..............
==............
==............
==............
==............
==............
==--..........
==............
==k...........
==............
==--..........
==............
==............
==............
==............
==............
==............
..............
..............
......0.......
......0.......
..............
==............
..............
......0.......
......0.......
..............
==............
==............
==............
==............
==............
==............
==............
==............
==k...........
==............
==............
==............
==............
==............
==............
==k...........
==k...........
==k...........
==............
==............
==ppp.........
==ppp.........
==............
==............
==............
==............
==............
==............
==............
==............
==............
==pp..........
==pp..........
==............
==............
..............
==--..........
..............
==----........
..............
==------......
..............
==--------....
==--------....
==............
==............
==............
==............
==............
==............
==............
==............
==F...........
==............
==............
==............
==A...........
