==A...........
==............
==............
==............
==............
==............
==............
==............
==............
==............
==............
==............
==............
==............
==............
==............
==............
==............
==.8..........
==............
==............
==............
==............
==............
==............
==............
==............
==............
==............
==............
==k...........
==............
==............
==............
==..8.........
==............
==............
==............
==............
==............
==............
==............
==............
==............
==............
==............
==............
==............
==............
==............
==............
==............
==............
==pppp........
==pppp........
==............
==............
==............
==............
==............
==...b...b....
==...b...b....
==...b...b....
==H..b...b....
==...b...b....
==...bH..b....
==...b...b....
==...b...b....
==............
..............
..............
==----........
==---.........
==--..........
==-...........
..............
..............
==............
==............
==............
==............
==............
==............
==............
==............
==............
==.8..........
==............
==............
==............
==............
==............
==............
==k...........
==............
==---.........
==............
==............
==............
==............
==............
==............
==............
==............
==............
==............
==............
==............
==............
==----........
==----........
==............
==............
==............
==............
==...b...b....
==...b...b....
==...bH..b....
==...b...b....
==H..b...b....
==...b...b....
==...b...b....
==...b...b....
==............
..............
..............
==pppp........
==pppp........
..............
..............
==............
==............
==............
==............
==............
==............
==............
==k...........
==............
==............
==............
==............
==............
==............
==............
==............
==H...........
==............
==............
==............
==............
==............
==............
==............
==............
==............
==............
==............
==............
==H...........
==............
==............
==............
==............
==............
==............
==............
==............
==ppp.........
==ppp.........
==............
==............
==............
==............
==............
==............
==............
==H...........
==............
==............
==............
==............
==............
==............
==............
==H...........
==............
==............
==............
==............
==...b........
==............
==............
==............
==............
==--..........
==............
..............
...-..........
..............
.....-........
..............
.......-......
..............
.........-....
.........-....
..............
..............
==............
==............
==............
==............
==............
==............
==F...........
==............
==............
==............
==............
==............
==............
==............
==A...........
